---------H-------------V----------------------------------------------------------------------------
-----------------------------------------------R----------------------------------------------------
-------------H------------------------------------------------------------------------------------V-
------------R------------------OOOOOOOOOOOOOOO--------------------------------------R---------------
-------------N------V----------OOOOOOOOOOOOOOO--N---------------------------------------------------
-------------------------------OOOOOOOOOOOOOOO----R----------R--------------------------------------
-------N-----------------------OOOOOOOOOOOOOOO----V-------------------------------------------------
-------------------------------OOOOOOOOOOOOOOO-------------R----------------------------------------
----------------------B--------OOOOOOOOOOOOOOO------------V-----------------------------------------
-------------------------------OOOOOOOOOOOOOOO------------------------R-----------------------------
-------------------N------B----OOOOOOOOOOOOOOO------------------------V-----------------------B-----
-------------R-----------------OOOOOOOOOOOOOOO------------------------------------------------------
---B-------H---------M---------OOOOOOOJOOOOOOO--------------------------------V--BH-----------------
-------------------------------OOOOOOOOOOOOOOO---------------R--------------------R-----------------
---------------------------HN--OOOOOOOOOOOOOOO------------------------N--------------------N--------
--------------R----------------OOOOOOOOOOOOOOO--------------R---------------R--------------------S--
------------V-------------V----OOOOOOOOOOOOOOO------------------------------------------------------
-------------------------------OOOOOOOOOOOOOOO----R------------------------------------R------------
-------------------------------OOOOOOOOOOOOOOO------------------------------------------------------
-------------------------------OOOOOOOOOOOOOOO---------------R---R----------------------S-----------
-------------H-----------------OOOOOOOOOOOOOOO-------V---------------B---------------------V--------
------------R------------------OOOOOOOOOOOOOOO---------------------------R--------------------------
N-----------------------------B---------------------N-----------------------------------------------
-------R------------------------------------------------------------------R-------------------------
-----V---N------------------------------------------------------------------------------------------
---------------------------------R---------------------R------------------------R-----------R-------
------------------------------OOOOOOOOOOOOOOO----------------------------------V-N-H------N---------
--------------------------R---OOOOOOOOOOOOOOO-------------------------------------------------------
------------------------------OOOOOOOOOOOOOOO---------------------------B---------------------------
--------------RR--R-----------OOOOOOOOOOOOOOO-------------------------------------------------------
-----------------B------------OOOOOOOOOOOOOOO-------------------------------------------V-----------
-----------------------R------OOOOOOOOOOOOOOO-----R-------------------------------------------------
---------------------HN-------OOOOOOOOOOOOOOO----------------------------------------H--------------
-R----------------------------OOOOOOOOOOOOOOO----------------N---------------------R----------R-----
--B---------------------------OOOOOOOOOOOOOOO---------------H--------------------H------------------
----------R-------------------OOOOOOOJOOOOOOO----R--------------------R-----------------------------
----------------------N-------OOOOOOOOOOOOOOO------------------B-----------------------H------------
------------------------------OOOOOOOOOOOOOOO--------R---------------------------------------------R
---H--------------------------OOOOOOOOOOOOOOO-------V-----------------------------------------------
-----------------R------------OOOOOOOOOOOOOOO------------------------R------------------------------
BV----------------------------OOOOOOOOOOOOOOO--------------------------H------------B---------------
-------S----------------------OOOOOOOOOOOOOOO-----------R----R----------------------S---------------
----------------------------N-OOOOOOOOOOOOOOO------M---BV--------------------V----------------------
------------------------------OOOOOOOOOOOOOOO---------------V--R--R---------------------------------
------------------------------OOOOOOOOOOOOOOO-------------------------------------------------------
------------------R---R--------------------R---------------------R-----S---------R------------------
---------------------------------------N------------------------------------------H-----------------
---------R---------------------------------R--------------------------------------------------------
-------------------------------N---------------------------------N-----------------M--------B-------
--------------------------------------------------------R------------R------------------------------
-------------------------------------------------------H-----H------------V--------H----------------
--------------------------------------------------------------------------R-------------------------
------H-------------------------------B-----------M-H------------N--------H-------------------------
-------------------------------------------R----R--------R--------R--------------------------N------
---B---------H-------------------V------------------------------M---------------------N-------------
--------------------------------------------R---R-----------V---------------------N-----------------
-----------------------------N-------H--------------V---------N------------------M------------------
----------------------R-----------------------------------------------------------------------------
-------H------------------------M--------------------------------N--------------------N-------------
---------S-----------------------------------------------R------R---------R-----------R-------------
---H----------------N------------------------------------------------------------H----------N-------
-------R---S----------------------------------------------------------------------------------------
---------------------M------NM------------V-H-------------------------------------------------------
---------------------------------------------R-R----------------------------------R-----------------
--------------------------------B-V-------V-----------------B--------------------------M----B-------
-----R-----------S-------------------------R------------------------------------R-------------------
----------------------------------------N----------------N----------------------H----------H--------
--------------------------------------------------------------R---R----V-----------------R----------
---V-----------------------------N-----------------------BV-----B----------------------B----B-------
--------------------------------------------------------V----R----------------N---------------------
------------------------------------------V-----------------------------------------N---------------
------------------------------------------------------R---------R-----------------------------------
----------------------------------------------------------------------------M-----------------------
------------R------------------------------------------------------R-------------------R------------
-----------------------------------------------M--------------------------B-------------------------
------------R--------------------------------------------------------------------------R------------
-------------------------------------------------------------H---------------------HH---------------
---------R----R----------------------------RR---------------------R---------------------------R-----
---------------------------------------------BB-----------------------V-----------------------------
--R--R--------------------------------------------------------------R---------------------R---------
----VB----------------H---V--------B--------------------H-----------------B--M------M-------V-------
---------------------------------------------------------------------------------------------------R
-------------------------------------B------------H----------------N---------N----------------------
----------------------------------------------------------------------------------------------------
