-----------------------V----------------------------------------------------------------------------
-R----------------------R------R---------------R---R-----------------------------------------R------
---------------------N------N----B-----------N------------------------N-----------------------------
-----R------R------------------------------R--R---------------R---------------------R---------------
-------------N---V--B-----------------------V---N----------------------------------------------V----
---------------------------R----------------R-----R----R-----R--------------------------------------
------------B--H--------------------------------------------------H---------------V-B------------N--
-----------------------------------------R-----------------R-----------------------R----------------
--B-------------------------------N-------------------------VM--H-------------------------B-V-------
----------------------------------------------------------------------R-----------------------------
-----------B--------------V-------------------------------------------VN----------------------B-----
-------------R--------------------------------------------------------------R-R---------------------
H--H-----------------M----------------------------------N---------------------V---H---------H-------
--R----------------------------------------------------------R---------------R----R---R-------------
N--------------B----H------H----H--H----------------------------------N--------------------N--------
--------------R-R-R--R------------H----------R--------------R---------------R--------------------S--
---------------------------------------------N-----------M------------------------------B-----------
--------R-R---------------------------------------R------------------------------------R------------
----------V-------------------------N------------------------------------------V----------B---------
-------------------------------------------------------------R---R----------------------S-----------
---------------------------------------N-------------V-------------------------------------V--------
------------R------------------------------------------------------------R--------------------------
N-----------------------------B--B------------------------------------------------------------------
-------R-------------------------------------------R--R-------------------R---------------R---------
--------------------------------------H--------------------------------B--------B-------------------
---------------------------------R---------------------R------------------------R-----------R-------
------------------------------B---V----------------------------------------------N--------N---------
-------------------R------R----------------------------------R--------------------------------------
----------------N---------------N-N------------------B----------------BHB---------------------------
--------------RR--R-----------------------------------------------------R---------------------------
----V-----------BB----------------------B----------------------------------------------------------B
-----------------------R-----R--------------------R-------------------------------------------------
--------------------V-N-----B------------N-------------------------------------------H--------------
-R--------------------------R----------V---------------------N---------------------R----------R-----
--B-----------H--------N-----------------B-----------V------HN---------------H---H------------H-----
----------R--------------------------------------R--------------------R-----------------------------
---V--N---------------H-------------V--------------------------B-----H----------------NH-----H--MH--
-----------------------------------------------------RR--------------------------------------------R
---H---------------------------------N--H-V---------V---H-----------------------------------B-------
-----------------R---------------------------------------------------R------------------------------
BH----------VB----V--------------V-----------------------B-------------H-H--------------------------
-------S----------------------R-------------------------R----R----------------------S---------------
----------------BH----------N---H-N--------B-------M----V----------B--------------------------------
-----------------------------------R-RR---------------------V--R--R---------------N---------R-------
------N--V---N-----------B-----------V------B------------------------H------------------------------
------------------R---R------------------R-R---------------------R-----S---------R------------------
------------------B--------------------N----H---------NV--------------------------------------------
---------R---------------------------------R--------------------------------------------------------
---H-------------N---H--------------------------B----------------N-----------------M-N------B------N
-------------H------------------------------------------R------------R------------------------------
---------N--------------------H----------H-------------H-----H-------------B--V---N-H---------------
--------------------------------------------------------------------------R-----------R-------------
------H-------------------H--V--------B-----------M----------------------------H--------VV--B-------
-------------------------------------------R----R--------R--------R----V---------------------N------
---B----------------------H------V---------------------------V--M-----------------H---N-------------
--------------------------------------------R---R-----------V---------------------N-----------------
-------------------------------------H--------------V--------H-------------------M--------------B---
----------------------R--------------------------------------------R-R------------------------------
V------H------------------------M---------------------------------------------------H---------------
---------S-----------------------------R--R--------------R------R---------R-----------R-------------
---H-------------------H----------------------------------B-------------H--------H----------N-------
-------R---S----------------------------------------------------------------------------------------
---V------BH---------MH-----NM--------------H-----B----N-------------------H-------B----------------
---R--------------------------------R--------R-R-----------------------------R----R----H------------
-------------------------------H----------V-----------------B-----------------------N--M------H-----
-----R-----------SR------------------------R------------------------------------R-------------------
--------------------------------------V--------BB--------N---------------------------------H--------
--------------------------------------------------------------R---R----V-----------------R---N------
---V--------N------------H-------V-----------------------BV----H----------------------------B-------
--------------------------------------------------R-----V----R----------------N---------------------
---------H----------------H---------------V--V--------------------------------------N---------------
-------------------R----------------------------R-----R---------R-----------------------------------
----------------B---------------------------------------V---------B---------M-N---------------------
------------R------------------------------------------------------R-------------------R------------
N-----------------H-----------------VB---------B----------------------------------------------------
------------R-------------------R--------R--------R------------------------------------R------------
----------H------------------------------------------------------------------M-----H----------------
---------R----R------------------R---------RR---------------------R---------------------------R-----
---------------------------------------------BB-----------------------------------------------------
--R--R---------------------------------R----------------------------R---------------------R---------
----------H-----------H---V----------B------------------H-------M---------B--M------M-------V-------
--------------------------------------------------------------R------------------------------------R
------------H--------------------------V------N---H----N-----------N--------------------------------
----------------------------------------------------------------------------------------------------
