--N--H------------------------N--B-B---------------HB---H-H-M---------H----M----N-----H-------------
-------------------------------------------------------S--------R--------R---R---R------------------
------------M-----------------------------------------------------------------B--------------M------
-------------R-------------------------------------R--------R-----------R------------R--------------
-----N-----------------------------------B----------------V---------------V-------------B--------BN-
----------------------------------R------------R----R--------------S-R--------------------------R---
-----N---N-----------BM---------N------H------------------------------------------------------------
-----R---------------------------R-------S-------------------R--R-----------------------------------
----------------N-----------------------------------------M--N----------B----------------------B----
---------R---------------------------------------------------------------------------R--------------
----------HV------------H--V------------------------------------------------------V----N------------
----------------------------------------------------------------------------------------------------
V--------------------------------------V-B-----------B--V-------------------------------------------
---------------R-------------R-------------------R------------------S-------R-----------------------
----------------------------------------------B---------N---B----------V--------------------------H-
R------------R-------------R--R-------R--------------------------------------------------R--R-------
----N------B-----------V--------B-------N----------N--H------B--------------------------------------
---R---R-------------------------------------------R---------R----R----------R----------------------
-----------------------------------------------B-------------N-------------B---B--------------------
---------------R------------------------------------------R-----------R--------R--------------------
-H----------------------------H-----------B--------------H-------------HH----H----------------------
--------------------------------------------------------S-------------------------------------------
--------------------N--------------------------------------------------------N----------B-----B-----
---------R--------------------R-----------------------R-R--------------R-------------------R--------
---------B--------------M----------------------H--B---B-------BV----V---------V---------------------
------------------------------------------------R----------------R-------------R--------------------
B-----B--------------------N-------------N---N-------------------------------H---H------------------
--------------------------------------------------------------------------R---R------------------R--
------N-----------------------B--------------H-------------------------------B----B---------B-------
------------------R----------------------------------R---------------------------R------------------
------------------------------------------------MN------------------------------------------N-------
---------------------R--------R--------------------------------R-----------R----RR--------S---------
--------------B----B----------M-------B----B------------------------------H--------B----------H-----
-----------------------------R------------------------------S---------------------------------------
-------------VN----------------------------H---------------B---------------------N---------------V--
----------------H------------------------------R----------------------------R-----------------------
---V----------------------------N----N--------------------------------------------------------------
----------------------------R----------R-------------------------------R---------R------R-----R-----
-----------------------------------NB-----B------------------H----------------------H--H------------
----S----------------------------------------------R----------------------S-------------------------
-V-----------M--V---------------------------------------------H------------V------------------------
-S---------------R---------------------------------------------------------------------R------SR----
---------N------------------------------------------------------------B---N--------N----------B---N-
-RR----------------------R-------------R---------------------------------R------------R---------R---
-----------------------B------------V---------------------------------------------------------------
---R---------------R---------------------------------R-----R----------------------------------------
-----------VB---------H-----------M-----------------------------------------------------------------
---------------------------------------------------------RR---------------------------R-------------
------------H------------------N-------------------------------N---------------------------B------H-
------------H-R---------R----------------------------------R----------------------------------------
-----V----------N--H-------N---------------V---------B--M------------H------------------------------
----V-R---R--------------RN----R---------------------------R------------------------R---------------
------------------M--B--N-----------------------M---------H------------------V------------H---------
R-------------------------------R------------------------------R--------------R---------------------
---------H----------B-----------------------------N--------------------H-------H--------------------
------------------------------R----------R--------------V---------------------NR--------------------
----N--------------------------V---------------------------------V---------B-------B--V-------------
-S--------------------------------------R-------------------------------------R---------------------
--------------H-----------------------H----H-----------B------------------------------------M-------
------------------------------H---R--------------R--------------------------------------------------
--------------NH----M-------H-----------------------B--B---B----------------------------------------
--------------------------R----------------------------V---------------------N----------------------
V-H------------H----------N-----------------------N--------B-------H----------BN--------N-----------
-----------------------------------------------R-------------------------------R----------------R---
-----------------------------------V-------------------------------------H---V----------------------
--V---------------R-----N---------------------------------------------------------------------------
--------------V----B---------------------------------------------------------------H----------------
-------S------------------R--------R--R---------------R------------------R----H-----------------R---
----------------------------------M----------------------------B-------B---B------------------------
--------------R-------------------------------------------------------------------------------------
------------------------------------------------------------------B------H-N--V--------------M--V-H-
-----R--------------------------------------R-R------------R------R-R---V---------------------N-----
---------------------------------------------------H-------------H---------V-B----------------------
----------------R-------------R---------------------------------------------------------------------
---------------------------------H------------H-H--B----B--------H----------H-----------------------
-------S------------------------R------------------------------------------R---------------R--------
---------------------N--------H-------V-V--------MN-------------------------------B-----------------
-R-----R------------------------------R----------------------------------R----R---------------------
--------------------------------------------H-------H-----------M------N-----H--------------------M-
-R----------------------------------------------------R-----------------------R----------------R----
---------N------------------M----M-----------------------------------------H-N--V---V---------------
-----R----------------------RR--R--------------RR-----------R---------------------------------------
-------------H--V--H--------------------------------N--------------V-H------------------BN------N---
-----------------------------------R----R---------R------------------------------------------R------
