---------H-------------V-B------------------------------H-------------------------------------------
-R----------------------R------R---------------R---R-----------------------------------------R------
----------------------------N-----------N---------------------------------------------------------V-
-----R------R------------------------------R--R---------------R---------------------R---------------
-------------N------V--H------------------------NB-------------H------------------------------------
---------------------------R----------------R-----R----R-----R--------------------------------------
-------N----B--------------B---------N------B-----V---------H---------------------V--------------N--
-----------------------------------------R-----------------R-----------------------R----------------
----------------------B-----------------------------------V--M--------------------------------------
----------------------------------------------------------------------R-----------------------------
-------------------N------B-------------------------------------------V---H---V--------N------B-----
-------------R--------------------------------------------------------------R-R---------------------
---------------------M----------------------V------------------------------V-----BH-----------------
--R----------------------------------------------------------R---------------R----R---R-------------
N--------------------------HN-----------------------------------------N----------------H---N--------
--------------R-R-R--R------------H----------R--------------R---------------R--------------------S--
--------------------------V------------------N------------------------------------------------------
--------R-R---------------------------------------R------------------------------------R------------
------------------------------------N---------V-------------------------------------------B---------
-------------------------------------------------------------R---R----------------------S-----------
-------------H-------------------------N-------------V---------------B---------------------V-------H
------------R------------------------------------------------------------R--------------------------
N-----------V-------H---------B--------------------------------H---------------V--------------------
-------R-------------------------------------------R--R-------------------R---------------R---------
-----V---N----------------------------N-------------------------------------------------------------
---------------------------------R---------------------R------------------------R-----------R-------
---------------------------N------V--------------------------------------------V-N-H----------------
-------------------R------R----------------------------------R--------------------------------------
----------------N---------------N-----------------------BN-------------HB---------------------------
--------------RR--R-----------------------------------------------------R---------------------------
----V------------B--------------------B-B-----------------------------------------------V-----------
-----------------------R-----R--------------------R-------------------------------------------------
---------------------H--------B-------N-----H-----------------------V---------H--B---H--------------
-R--------------------------R----------V---------------------N---------------------R----------R-----
--B-----------H----------V---------------V------------------HN-------------------H------------------
----------R--------------------------------------R--------------------R-----------------------------
----------------------N-------------V--------------------------B-----------------------H--------M---
-----------------------------------------------------RR--------------------------------------------R
---H-----------------------------N------H-----------V---H-------------------------H-----------------
-----------------R---------------------------------------------------R------------------------------
BV--------V-V----------------------------------------------------------H------------B-----H---------
-------S----------------------R-------------------------R----R----------------------S---------------
----------------------------N--------------B-------N---BV----------V------V--V----------------------
-----------------------------------R-RR---------------------V--R--R---------------N---------R-------
-------------------------B------------M-----B-------------------------------------------------------
------------------R---R------------------R-R---------------------R-----S---------R------------------
------------------B--------------------N-------V------N----B-----M----------------------------------
---------R---------------------------------R--------------------------------------------------------
---------------------------------------------M-------------------N-----------------M--------B-V-----
-------------H------------------------------------------R------------R------------------------------
--V-----------------------------V----------------------H-----H------------V---V---N----B------------
--------------------------------------------------------------------------R-----------R-------------
------H-----B-----------------BN------B-----------M-H------------N--------H-------------V---B--B----
-------------------------------------------R----R--------R--------R----V---------------------N------
---B-----------------------------V------------N-N---------------M---------------------N-------------
--------------------------------------------R---R-----------V---------------------N-----------------
-----------------------------N-------H--------------V---------N--H---------------M------------------
----------------------R--------------------------------------------R-R------------------------------
-------H------------------------M--------B-----------------------N--------------------NV------------
---------S-----------------------------R--R--------------R------R---------R-----------R-------------
---H----------------N--------------------------B------------------------H--------H----------NB--V---
-------R---S----------------------------------------------------------------------------------------
---------------------MH-----NM----------V-V-------B----N-------------------H-------V----------------
---R--------------------------------R--------R-R-----------------------------R----R----H------------
-----------------------------B--B-V-------V-----------------B--------------------------M----B-H-----
-----R-----------SR------------------------R------------------------------------R-------------------
V-------------------------------------V----B-------------N----------------------H----------H---N----
--------------------------------------------------------------R---R----V-----------------R---N------
---V-B------N------------H------N------------------------BV-----B----------------------B------------
--------------------------------------------------R-----V----R----------------N---------------------
-----------N----------------------V-------V-----------------------------------------N-----N---------
-------------------R----------------------------R-----R---------R-----------------------------------
----------------B-----------------------------------------------------------M-N----B----------------
------------R------------------------------------------------------R-------------------R------------
---------------N--------------------V-------H--M----------------------------------------------------
------------R-------------------R--------R--------R------------------------------------R------------
------------------------------------V------------------------H---------------M------H---------------
---------R----R------------------R---------RR---------------------R---------------------------R-----
---------------------------------------------BB----------N------------V--------------H--------------
--R--R---------------------------------R----------------------------R---------------------R---------
----VB----H-----------H---V-----------------------------H---N-------------B---------M-------V-------
--------------------------------------------------------------R------------------------------------R
-------------------------------------B--------N---H----N-----------N---------N----------H-----------
----------------------------------------------------------------------------------------------------
