----------------------B------------------N---------------------------------------V---M--------H-----
-----------R----------------------------------------------------------------------------------------
-----------------M-----------------------------------------------------------------------------V----
----------R-------R---------------------R-----------------R---R---------R--R------------------------
-------------------------------------------------------------------------------H------------------B-
-------------------------------------------------R-------------------------------R------------------
-------BB----------------------V---------------------------------------VH------------------------H-B
------------------------R-------------------------R-------------------------------------------------
-----M-B-----N------------------------------------------------V----B------N--N-----B-------H-----H--
------------------------------------R--------------------------------------------------------------S
V------------B----------------N------------------H------N----------N-V------V-----------------------
-R--------------------------------------------------------------------------------------------------
-----------------------------------------------------------------------H----------H--H---------H----
-------------------R-R------------------------------------------R---------------------S-------------
---V---------H---N----V----B-----------------------------------H------HH----------------H-------N---
------------------R---------------R---------------R-----------------------------------RR------------
---------------B-N-B-----N--------------------------------H-----------------------------------------
----R-----------------R-------------------------R-------------------------------------------R-------
----------H----------H-------V---------V--H----------B------V-------B--------HN--V------V-----------
------------------R------------------------------R--------R----------------R------------------------
----------V-----------N-----------------------------------------------------------------H-----------
------------------------------R--------------------------------H--------R-------------R-------------
------------------------------------------------------V----------------------------B-M----------B---
-------------------R-----------------------R-----R---R----------------------------------------------
---------------------------B------------------------------V-----------------------------------------
S---------R-------------------------------------------------R-----SR-----------------------S--------
---------------------------------H--------------V------------V---------------B----------------------
---------------------------R------------------------------------------------------------------------
------H-----------------------B------B---------------------V-----------------M----------------------
---------------------------------------------R-------R----R-------------------------------------R---
------B------------------------------V----------------------------H---B----------------------N------
--------------------------------------------------------R------------------------------------------R
V----------------------------------H--------M------------V-V---B--N---------------------------------
--RR-------R-----------------------------------R-----R-----R---------------------------R------------
----H--------------------MH----------BH---------B----NVH----------------------------------------BV--
--------R---R--------------R-----------------R-----R-----SR--------R---------------H----------------
-H----V----------------H----------------------------------------M---H----------------------------B--
-------R------------R-----R------------------------------------------------------------------R------
---------H--V--------------------------H------------B----------------------------V----------V-------
-------------R----R---------------------------------------------------------------R----------------R
B------------------------V--MH-M--------------------------------------------------------------------
---------------------------------R---------R--------------------------------------------R-R---------
--------------------------M------V-M---N----H-------------------H--------V------B-H--V--------------
-------R-----------------------------------------------------------R------R-------------------------
------------V---------V-----------------------------------------------------------------------------
--------R------V------R--------------N----R---------R--R--------------------------------------------
-------B---N--B----------------H------------N---V--B------V----------V----N-----------------H-------
-----------R----R--H--------------------------------------------------R--------R--------------------
--H------VN----------------------------V-----------H----------------B-------------------------------
--------------R----R-------------R----R--------------------------------------R--R------R------------
----B--N---------H------------------------B--------------------N--M-------------------B-------------
-----------------------------------------R---------------V---------------------N------R---------R---
------------------------------------------------------------------N-----------------N---------------
------------------R---------------------------H-------------R-----------R---------------------------
--H-----------------N------------------------------------N-----B-----------------B-----------B----V-
-R----------------------------------------------------------------------------------------------R---
----------------------NV-------B-------------------------------------------------------------------H
----------------------------------R----------R-------VR------------R-------N------------------------
-------------------B----------H----------------------------------------V----------------------------
----------------------------------------------R---R---R---------------------------------------------
----------B-------------N---------------B-------H-V---------------N---------------------------------
-----R-------------------------------------------------------R-------------------S-----R---R--------
-----H----------V-------------------------H------V------------B--------------------------M----------
------R-------------------------------------R--------------RR---------------------------------R-----
---------H----------------------------NN----N---------------------------B------H-------------------M
-R------S-----R-----------------R-----------------R-------------------------------------------------
-----B-----------------------------------------M----------H----------------H---------B--N----V------
----------------------------------R-----------------------------------------------------------------
----------------M----NV------------V-V-------------------------------BH---N-------------------------
--------R--R----------------------R-----------------------------------------------------R-----------
------H-------H------------B----------------------------------------------------------------------H-
--------------------------------------------R------------------------------R------------------------
---------------------------B---H-------------------HB--N---------------------------------V---V------
-----------R----R--V-----R---------------N----------------------R------------R--------R-------------
---------------------------N-----N-B-------------------------------------B--------------------B-----
----------------------------------------------R------------------------------------------------R----
-------------N--------------M-------------------B---------------V-----H-----------------------B-----
----R----------------------R--V---------------------N-----------------------------------------------
-B------H----B------V------------------N-------N-----------------V----------------------------------
----------------R----R-----------------------------------R----------------------------------------R-
--------------H----NB---------------------H------------------------------H-------------B---B-------B
--R-R------------------------S----------------R-----------------R---R-R----------------R------------
----------------V----------B-----N------VH------------------N-----------------------H--------------B
--------------R------------------------R-------------------------R--------------R-------------------
