------------B-------V-------------------------------------N------------N---------------------------V
-----------M----M--------------------M--------------------------------------------------------------
----------V--V---------V--N----------------------------V--H----H------------------------------------
----------------------------------------------------------------------------------------------------
--------B---------------------------------R-------B-------------------------------------------------
---------------------------------------------------------------------------M------------------M-----
---------------------------------------V----R----------------B------------H-------------------------
---------M--------------M---------------------------M---------------XXS---M-------------------------
----N--------------------------------------B--V--------------------XXXX-----B-----------------------
----------M-------------------------------------------------------XXXXX-----------------------------
------------N------------V---------------------------------------XXXXX-----------------------------B
-----------------------------------------------------M----------XXXXX-------------------------------
-------------------------------------------------------H-------XXXXX-----------V-H-----V------------
-----------------------M------------------------------------M-XXXXX---------------------------------
-----------------------------------------------V-------------XXXXX----------------------------------
-------------------------------------------M----------------XXXXX-----------------------------------
-----H----------------------------------------------------BXXXXX-------------N----------H-----------
----------------------------------------------------------XXXXX-------------------------------------
---------------V-----------------------------------------XXXXX--------R----------------------------H
--------------M-----------------------------------------XXXXX---------------------------------------
-----------H-------------------------------------------XXXXX--------------B----------------------B--
------------------------------------------------------XXXXX----M--------M---------------------------
-----------N---------N-----------B---N---------------XXXXX------OOOOOOOOOOOOOOO------------H--------
----------------------------------------------------XXXXX-------OOOOOOOOOOOOOOO----M----------------
-R--------------------------------------------------XXXX---R----OOOOOOOOOOOOOOO---------------------
-----M----------------------------------------------XXX---------OOOOOOOOOOOOOOO---------------------
--------------------------------N-------------------XXX---------OOOOOOOOOOOOOOO-------N-------------
--------------M-------------------------------------XXX---------OOOOOOOOOOOOOOO----------XXS--------
--N------------------------------V------------------XXX---------OOOOOOOOOOOOOOO---------XXXX-------V
-------M--------------------------------------------XXXM--M-----OOOOOOOOOOOOOOO--------XXXXX--------
B-R-----R-------------------------------------------XXX---------OOOOOOOOOOOOOOO-------XXXXX-------B-
----------------------------------------------------XXX---------OOOOOOOJOOOOOOO--M---XXXXX----------
-------------------------------------------H--------XXX---------OOOOOOOOOOOOOOO-----XXXXX-----------
----------------M---------------------M-------------XXX--------MOOOOOOOOOOOOOOO----XXXXX------------
----------BH----------------------------------------XXX---------OOOOOOOOOOOOOOO---XXXXX------------N
----------------------------------------------------XXX---------OOOOOOOOOOOOOOO--XXXXX--------------
-------------------N--H--------------------------V-XXXX-V-------OOOOOOOOOOOOOOO-XXXXX---------------
-----------------------------------M--------------XXXXX---------OOOOOOOOOOOOOOOXXXXX----------------
-----------N----XXX------N-----------------------XXXXX---N------OOOOOOOOOOOOOOOXXXX--R----B---------
----------------SXXX-----------------------------XXXX-----------OOOOOOOOOOOOOOOXSX---------------M--
----------------XXXXXXXXXXXXXXXXXXXXXXX----------XXX---------H--OOOOOOOOOOOOOOOXX------H------------
--M--------------XXXXXXXXXXXXXXXXXXXXXXXXXXXXXXXXXXXXXXXXXXXXXXXXXXXXXXXXXXXXXXXX--------M----------
----XXXXXXXXXXXXXXXXXXXXXXXXXXXXXXXXXXXXXXXXXXXXXXXXXXXXXXXXXXXXXXXXXXXXXXXXXXXX------R-------------
---XXXXXXXXXXXXXXXXXXXXXXXXXXXXXXXXXXXXXXXXXXXXXXXXXXXXXXXXXXXXXXXXXXXXXXXXXXXX---------------------
-HXXXXXOOOOOOOOOOOOOOOXXXXXXXXXXXXXXXXX-----XXXXXXXX----XXXXXXXXXXXXXXX---B-------V---------------N-
-XXXXXMOOOOOOOOOOOOOOO------------M---XXXXXXXXXXXXXX-----XXXXXXXXXXXXXXX----------------------------
-XXXX--OOOOOOOOOOOOOOO--H------------XXXXXXXXXXXXXXXR------------XXXXXXXX---------------------------
-SXX---OOOOOOOOOOOOOOO--------------XXXXXXXXXXXXXXX------------------XXXXX--------------------------
-----H-OOOOOOOOOOOOOOO------------NXXXXX-XXXXXXXXX--------------------XXXXX-V---------------B-------
-------OOOOOOOOOOOOOOO------------XXXXX-XXXXX-XSX----------------------XXXXX-------M----------------
-------OOOOOOOOOOOOOOO-----------XXXXX-XXXXX---HV-----------------------XXXXX-----------------------
-------OOOOOOOOOOOOOOO----------XXXXX-XXXXX------------------------------XXXXX----------------------
-------OOOOOOOOOOOOOOO---------XXXXX-XXXXX--------------------------------XXXXX-------------------R-
-------OOOOOOOJOOOOOOO--------XXXXX-XXXXX----------------------------------XXXXX--------------------
----V--OOOOOOOOOOOOOOO-------XXXXX-XXXXX------------------------------------XXXXX-------------------
-------OOOOOOOOOOOOOOO------XXXXX-XXXXX-------------------------------M----M-XXXXX------------------
-------OOOOOOOOOOOOOOO-----XXXXX--XXXX--------------------V------------------VXXXXX-----------------
--M----OOOOOOOOOOOOOOO----XXXXX---SXX-----M------M--------------------M--------XXXXX----------------
-------OOOOOOOOOOOOOOO---XXXXX---------------------B----------------------------XXXXX---------------
-------OOOOOOOOOOOOOOO--XXXXX----------------------------------------------------XXXXX--------M-----
-------OOOOOOOOOOOOOOOXXXXXX----H---------------------------------B---------------XXXXX-----B-------
-------OOOOOOOOOOOOOOOXXXXX---------M------------------M---------------------------XXXXX------------
---B---OOOOOOOOOOOOOOOXXXX-----------------N-----------------------N----------------XXXXX-----------
---------M------XXXXXXXX-----M-------------------------------------------------------XXXXX----------
---------------XXXXXXXX-----------------------------------H---------------------------XXXXX---------
--------M-----XXXXX--------------------------------------------------------------------XXXXX--------
-------------XXXXX----------------------------------------------------------------------XXXXX-------
------------XXXXX--------------------------------------------------------M---------------XXXXX------
-----------XXXXX-------------------N--H--N-------------------------------------B----------XXXX------
----------XXXXX----------------------------------------------------------------------------XXS------
---------XXXXX----------------------------H------------------------------V------V-------------------
--------XXXXX-----------------------------------M---------------------------------------------------
--------XXXX--------------R-------------------------------------------------------------------------
--------SXX--------------M--------------------------------------------------------------------------
---------------------H---------------V-----------------------------------------N--------V----------H
-------------------------------------------------------------------M--------------------------------
-----------------------------------------------------R----------------------------H-------N---------
----M-------------------------------------M---------------M-----------------------------------------
--------------------------------------------------------V--------R-------------N-----V--------------
------------------------------------M----------------------------------------------------------M----
------------B-----NN----------------------------N----R---------------------------------------R------
------------------------------------------------------------------------------------------M---------
------------------------------------------V----------------------------------------------------N----
-------------------------------------------------M-----------------------------M-----M--------------
