--------------------N-----------------N-------------B----------------------------H------------------
-----------R----------------------------------------------------------------------------------------
----H------B-B---------------------------V----------------------B-------B---V----------H------------
----------R-------R---------------------R-----------------R---R---------R--R------------S-----------
--------------------H-----H-V-----------H-------------V--------HM-------------------------------B---
-------------------------------------------------R-------------------------------R------------------
-----------------------------------N----------------------------V------N--HB----------B-----------B-
------------------------R-------------------------R-------------------------------------------------
----------------N----V-----------N-----------BB-H-------------------H-------N----------H------------
------------------------------------R---------------------------------------------------------------
------N--------------------N-----------------------------------------------------------------B------
-R--------------------------------------------------------------------------------------------------
---------------------B--------V--------B------------------------------------------------------V-----
-------------------R-R------------------------------------------R-----------------------------------
----M------------------------M---------H--------------------------------------------V---------------
------------------R---------------R---------------R-----------------------------------RR------------
---------H--------------------------------V-----B----------------------------H-----------------N----
----R-----------------R-------------------------R-------------------------------------------R-------
----H-----------------H------------------------------------------H-----------H-B-----N--------------
------------------R------------------------------R--------R----------------R------------------------
-------N--------------BH--BH----------------------H----------------N----------B------------V-------N
------------------------------R--------------------------------H--------R-------------R-------------
--------------NN--------V------------------------------H------------------N------------M---V-------H
-------------------R-----------------------R-----R---R----------------------------------------------
-------N----------------N--------H---B-H----------------N----------B---------V-----N-------H---B----
S---------R-------------------------------------------------R-----RR--------------------------------
--------------------------------------------------N--N---------------B-------------H----------------
---------------------------R------------------------------------------------------------------------
H--------N---V---H------H---------------------H------H----V----V---------------B------H-------------
---------------------------------------------R-------R----R-------------------------------------R---
----------------V----H--------------------------------------------------------B--N-----------N------
--------------------------------------------------------R------------------------------------------R
-------------------------------------B------M----------H--V-------N----------------------V--------V-
--RR-------R-----------------------------------R-----R-----R---------------------------R------------
------------------N-------H------------------------V--B------------V----N--------H------------------
--------R---R--------------R-----------------R-----R-----SR--------R---------------H-------------S--
--------N-------------------HB---------------------------V------M----H-------------------------H---V
-------R------------R-----R------------------------------------------------------------------R------
----------------N------H-----H----------N-----H------------------------VH--NNN------N---------------
-------------R----R---------------------------------------------------------------R----------------R
---------------------------M------------------V------------V---------B------------------------V---B-
---------------------------------R---------R--------------------------------------------R-R---------
----H-----------V--M---------------M------------------V---------------------------------------------
-------R-----------------------------------------------------------R------R-------------------------
------------------------------------------------------------B---------B-------------------M---------
--------R------V------R--------------N----R---------RS-R--------------------------------------------
----------------------N---N------------------------------N------H-----------------------H---H---N---
-----------R----R--H--------------------------------------------------R---S----R--------------------
--M-----------------------------V------------------------H---------N---H-----------------V---------B
--------------R----R-------------R----R--------------------------------------R--R------R------------
-----VM------V-----------V-------------------------------------------------------------V------------
-----------------------------------------R-----------S---V---------------------N------R---------R---
--------------------------------------N-----------------------------N-----------------M-------------
------------------R---------------------------H-------------R-----------R---------------------------
------------B---------------------------------------------------------------------------------------
-R----------------------------------------------------------------------------------------------R---
-----------------------------------------V------------------------------N----N-------N--------------
-----------------------S----------R----------R-------VR------------R-------N------------------------
--------------------------V---H-----------B-----------------N-----------------------------------H---
--------------------S-------------------------R---R---R---------------------------------------------
-------------------------------V--------V-----------------V----------------------------H------------
-----R-------------------------------------------------------R-------------------------R---R--------
-------------------------------------------V------------------------------H------N--H--V------------
------R-------------------------------------R--------------RR---------------------------------R-----
------------------------------------------------------------------------BN--------------------------
-R------R-----R-----------------R-----------------R-------------------------------------------------
---------V-H---H---------N----------------B--V------------------------------------------------------
----------------------------------R-----------------------------------------------------------------
B-----B---------------------------------H--------------------V--------------------V-----------------
--------R--R----------------------R-----------------------------------------------------R-----------
N---B---------V-------------V----H---H--------------H--------B------V------------------------N---V--
--------------------------------------------R------------------------------R------------------------
-------H-B------------B---------------------H--H-----------H----------------------------------------
-----------R----R--V-----R---------------N----------------------R------------R--------R-------------
---------------------------------------------------------H-N-------B--------------------------------
----------------------------------------------R------------------------------------------------R----
-------------V--------------------------B------B---------------------------------------------------B
----R----------------------R--V-----------------S---N--------------------S--------------------------
---------M--------------------------------V-----VN--H----------------------------N------------------
----------------R----R-----------------------------------R----------------------------------------R-
---------------------H----------M---------H----V-----------------------N----------------------------
--R-R-----------------------------------------R-----------------R---R-R----------------R------------
-----------H----B------------------------------------------MV-----------B----B--------------------B-
--------------R------------------------R-------------------------R--------------R-------------------
