-----------------------H---------B----------------------H-H--------M--H----M-----------N------------
-------------------------------------------------------S--------R--------R---R---R------------------
-----------------------------------------------------------------NH---------V-B--------------MV--H--
-------------R-------------------------------------R--------R-----------R------------R--------------
-----------------N-----------------------B---------------------------------------N------B---------N-
----------------------------------R------------R----R--------------S-R--------------------------R---
-------------------------------------------------------BH-----H------------------B------------------
-----R---------------------------R-------S-------------------R--R-----------------------------------
--------------------------------B--------------V-------N---B----------V-----------------------------
---------R---------------------------------------------------------------------------R--------------
-------N---B--------------------------H---------------------------------------------------------H---
----------------------------------------------------------------------------------------------------
----------B---B----------N--------------V------V----V---------------------------------H-------------
---------------R-------------R-------------------R------------------S-------R-----------------------
----------------------------------------------N---V-----N---B-------H--V----------------------------
R------------R-------------R--R-------R--------------------------------------------------R--R-------
H------------------N-------------------------------N---N-----B-----------------------------B--------
---R---R-------------------------------------------R---------R----R----------R----------------------
------------------------------------------------B------------------------------V--------------------
---------------R------------------------------------------R-----------R--------R--------------------
-N----------------B---------------V-------B-------------B---------V-M-------------------------------
--------------------------------------------------------S-------------------------------------------
--------------------------------------------------------------------------------------N-------------
---------R--------------------R-----------------------R-R--------------R-------------------R--------
---------B--B-----------B---B----------------V----B-N-------N-BV----------N---------------------M---
------------------------------------------------R----------------R-------------R--------------------
B-------B------------------------------------N------------------------M-----------------------------
--------------------------------------------------------------------------R---R------------------R--
---B--------------------------B------N------V------------------------HV-----H-----B---------B-------
------------------R----------------------------------R---------------------------R------------------
-----------------H-V-H--------------------V------N------------------------V-------------N---N-------
---------------------R--------R--------------------------------R-----------R----RR--------S---------
---------------------------------V---------B----------H-------------------H-------------------B-----
-----------------------------R------------------------------S---------------------------------------
------N-----N------------V-----------------H----B----------------N--------------V---------------B---
----------------H------------------------------R----------------------------R-----------------------
--------N------N---------------------------------V-N-V--------N-------------------------------------
----------------------------R----------R-------------------------------R---------R------R-----R-----
-----BN------------------------B----B--------------V------N------------------H----------------------
----S----------------------------------------------R----------------------S-------------------------
---------V---M--B----------------------N-------------V--N------------------V-----V------------------
-S---------------R---------------------------------------------------------------------R------SR----
-----------V----------------V---------N----N--------------B----------B----N------------------H------
-RR----------------------R-------------R---------------------------------R------------R---------R---
-----------H--------N------------B--V-------------------------------V-------------------------------
---R---------------R---------------------------------R-----R----------------------------------------
----------H----------------N------------------------------------------------------------------------
---------------------------------------------------------RR---------------------------R-------------
------V-----H------------------N---------------------H-B----------------------------------M---------
------------H-R---------R----------------------------------R----------------------------------------
--------------------------NN----------N--------------BN-M---------------N-----V----------B----------
----V-R---R--------------RN----R---------------------------R------------------------R---------------
--------------------NN--------------------------M---------------------------------------------------
R-------------------------------R------------------------------R--------------R---------------------
---------H-------------------M-----------B--------N--------------H-------------H-----------------B--
------------------------------R----------R--------------V---------------------NR--------------------
B---N---------------------------V-----------------H--------------V--------B-H------B--V---------H---
-S--------------------------------------R-------------------------------------R---------------------
-----------------------------------------H--------------V-------V-----------------------H-----------
------------------------------H---R--------------R--------------------------------------------------
---------------H----M-----------------------------V-------------------------------------------------
--------------------------R----------------------------V---------------------N----------------------
V----B---------------------------VN-----B-------------------------------------N---------H-----------
-----------------------------------------------R-------------------------------R----------------R---
---------------------------------B----H-------------------------------B-----------------------------
--V---------------R-----N---------------------------------------------------------------------------
----------B---V----B----------------------V-B-------B------------------------------H------B---------
-------S------------------R--------R--R---------------R------------------R----H-----------------R---
---------------------------------------------------------------B-----------------H------VV----------
--------------R-------------------------------------------------------------------------------------
-V---------------------N------------------------------------------B------H----H--------------M------
-----R--------------------------------------R-R------------R------R-R---V---------------------N-----
---------------------------N----------N----------H--V---------N--H----------------H-----------------
----------------R-------------R---------------------------------------------------------------------
----------------------------------------------H--N--------------------------------------------------
-------S------------------------R------------------------------------------R---------------R--------
-----------H--------------------------V-VH-------------N--V-N---------------------------------------
-R-----R------------------------------R----------------------------------R----R---------------------
------------------------------------H---------------H-----------M----------H---B------------------M-
-R----------------------------------------------------R-----------------------R----------------R----
--------------B--H------------------------------V-N------------B-----------H----V-------N-----H-----
-----R----------------------RR--R--------------RR-----------R---------------------------------------
----------------V---------------------------------------------N----V-V----------------------N---BH--
-----------------------------------R----R---------R------------------------------------------R------
