--------------------N-----------------N-------------B--------------V-------------H------------------
-----------R----------------------------------------------------------------------------------------
----H--------B---------------------------V----------------------B-------B--------------H------------
----------R-------R---------------------R-----------------R---R---------R--R------------S-----------
--------------------H-----M-V-----------H----------------------HM-------------------------------B---
-------------------------------------------------R-------------------------------R------------------
----------------------------------------------------------------V------N---B--------V-B----V------B-
------------------------R-------------------------R-------------------------------------------------
----------------N----V-----------N-----------BB-H-------------------H-------N----------H------------
------------------------------------R---------------------------------------------------------------
------N--------------------N----------------------------B------------------------------------B------
-R--------------------------------------------------------------------------------------------------
---------------------B--------V--------B------------------------------------------------------V-----
-------------------R-R------------------------------------------R-----------------------------------
----M------------------------M------------------------------------------------------V---------------
------------------R---------------R---------------R-----------------------------------RR------------
---------H--------------------------------V---------N------------------------H-----------------N----
----R-----------------R-------------------------R-------------------------------------------R-------
----------------------H------------------------------------------------------H-B-----N--------------
------------------R------------------------------R--------R----------------R------------------------
-------B--------------BH--BH------------B--------------------------N-----------------------V-------N
------------------------------R--------------------------------H--------R-------------R-------------
--------------NN--------V------------------------------H------------------N------------M---V-------H
-------------------R-----------------------R-----R---R----------------------------------------------
-------N-----------B----N--------H---B-H----------------N----------B---------V-----N-------H---B----
S---------R-------------------------------------------------R-----RR--------------------------------
--------------------------------------------------N--N---------------B-------------H----------------
---------------------------R------------------------------------------------------------------------
H------------V---H----------------------------H------H----V----V---V-----------B------H-------------
---------------------------------------------R-------R----R-------------------------------------R---
----------------V-------------------------------------------------------------B--N-----------N-----H
--------------------------------------------------------R------------------------------------------R
-------------------------------------B------M----------H--V-------N----------------------V--------V-
--RR-------R-----------------------------------R-----R-----R---------------------------R------------
--------------------------H------------------------V--B------------V----N--------H------------------
--------R---R--------------R-----------------R-----R-----SR--------R---------------H-------------S--
--------N-------------------HB----------------------------------M----H-------------------------H---V
-------R------------R-----R------------------------------------------------------------------R------
----------------N------H----------------N-----H------------------------VH--NNN------N---------------
-------------R----R---------------------------------------------------------------R----------------R
---------------------------M------------------V------------V---------B------------------------H---B-
---------------------------------R---------R--------------------------------------------R-R---------
----H-----------V--M---------------M------B-----------V------H--------------------------------------
-------R-----------------------------------------------------------R------R-------------------------
----------------------------------------------------------------------B-------------------M---------
--------R------V------R--------------N----R---------RS-R--------------------------------------------
----------------------N---N---------------V--------------N------H-----------------------H---H---N---
-----------R----R--H--------------------------------------------------R---S----R--------------------
--M------------------------------------------------------H---V-----N-------------------------------B
--------------R----R-------------R----R--------------------------------------R--R------R------------
-----VM------V---------V-V-----------------------------------H-------------------------V-----------N
-----------------------------------------R-----------S---V---------------------N------R---------R---
--------------------------------------N-----------------------------N-----------------M-------------
------------------R---------------------------H-------------R-----------R---------------------------
-----------------N--B-------------------------------------------------------------------------------
-R----------------------------------------------------------------------------------------------R---
------B----------V-----------------------V------------------------------N----N-------N--------------
-----------------------S----------R----------R-------VR------------R-------N------------------------
------------------------------H-----------B-----------------N-----------------------------------H---
--------------------S-------------------------R---R---R---------------------------------------------
-------------------------------V--------V-----------------V----------------------------H------------
-----R-------------------------------------------------------R-------------------------R---R--------
-------------------------------------------V------------------------------H---------H--V------------
------R-------------------------------------R--------------RR---------------------------------R-----
------------------------------------------------------------------------BN-------------B------------
-R------R-----R-----------------R-----------------R-------------------------------------------------
---------V-H---H-------------------------NB--V------------------------------------------------------
----------------------------------R-----------------------------------------------------------------
----------------------------------------H----N--H------------V---------------------V----------------
--------R--R----------------------R-----------------------------------------------------R-----------
N---B---------V-------------V--------H----N---------H--------B------V------------------------N---V--
--------------------------------------------R------------------------------R------------------------
-------H---------H----B-----------N---------H--------------H--------N-------------------------------
-----------R----R--V-----R---------------N----------------------R------------R--------R-------------
-----------------------------------------------H---------H-N-------B--------------------------------
----------------------------------------------R------------------------------------------------R----
-------------V--------------------------B------B---------------------------------------------------B
----R----------------------R--V-----------------S---N--------------------S--------------------------
----N----M-------------------B------------V------N-VH----------------------------N------------------
----------------R----R-----------------------------------R----------------------------------------R-
---------------------H----------M-V------------V-----------------------N----------------------------
--R-R-----------------------------------------R-----------------R---R-R----------------R------------
-----------H----B------------------------B-----------------M------------B----B--------------------B-
--------------R------------------------R-------------------------R--------------R-------------------
