----------------------B--------------------------------------------------------------M--------------
-----------R----------------------------------------------------------------------------------------
--------------------------------------------------H-------------------V-----------------------------
----------R-------R---------------------R-----------------R---R---------R--R------------------------
-----------------------H-H---------------------------------------V--B-------------------N-----------
-------------------------------------------------R-------------------------------R------------------
-B---------------------------------HN----M--------------------------------------------B------N---H--
------------------------R-------------------------R-------------------------------------------------
-----M-------N---------H------VB----------------------H---------------------N------------------V-H--
------------------------------------R--------------------------------------------------------------S
V------------B------------------------------------------N------------V--VB--------------------B-----
-R--------------------------------------------------------------------------------------------------
-----V-------------------------------------H---------------------------------------------------H----
-------------------R-R------------------------------------------R---------------------S-------------
--------B-------------------------------------------------------------H-----------------H-----------
------------------R---------------R---------------R-----------------------------------RR------------
----H---------------V-------N----B----------------------------------------------N--B----------N-----
----R-----------------R-------------------------R-------------------------------------------R-------
---V------H----B-------------VH-H---------------------------V-------B---------N---H-----V-----------
------------------R------------------------------R--------R----------------R------------------------
----NB--------------B-------H---------------------N-----------------------------------------N---B---
------------------------------R--------------------------------H--------R-------------R-------------
--V---B------------------------------V-----------H-----H--------------------------------------------
-------------------R-----------------------R-----R---R----------------------------------------------
----M----------------------B-B----------------------------N-----------------------------------------
S---------R-------------------------------------------------R-----SR-----------------------S--------
--------------------B-B------------------H---------------------------H-------B----V-----------------
---------------------------R------------------------------------------------------------------------
---------------V--------------B----------M-------------------V----------------------------V---------
---------------------------------------------R-------R----R-------------------------------------R---
------B-----------------------H----------------------N-----------------------------------VN---------
--------------------------------------------------------R------------------------------------------R
---------------------------------------------------------------B----------H-------------V-----------
--RR-------R-----------------------------------R-----R-----R---------------------------R------------
--------------------------N----------BH---------B------------------------N--------------------------
--------R---R--------------R-----------------R-----R-----SR--------R---------------H----------------
-----------------------------------------------------B----------M---H-------------------------------
-------R------------R-----R------------------------------------------------------------------R------
---------------------H------------V-------------------------V---------------------------------------
-------------R----R---------------------------------------------------------------R----------------R
----------------V--VH--------------------------H----------N-------HV------B-----------B-------------
---------------------------------R---------R--------------------------------------------R-R---------
------V-----------V-------M---B--------B---N-----V--------------------------------------------------
-------R-----------------------------------------------------------R------R-------------------------
---------B----------V--------------------------H-----------------N-----V-----------N-----HM-BM------
--------R------V------R--------------N----R---------R--R--------------------------------------------
-------B------M--V-----------------------B--N---V-----------H-------B--------------------------H----
-----------R----R--H--------------------------------------------------R--------R--------------------
--H---------------------------------VH---------------------B-----------------------------------N----
--------------R----R-------------R----R--------------------------------------R--R------R------------
--VN----------N----------------------H--------------------------B---V-----------H-------------------
-----------------------------------------R---------------V---------------------N------R---------R---
---------------N--------------------------------------------HV-V-------------------BN--------N------
------------------R---------------------------H-------------R-----------R---------------------------
------------------N-------------------------------H---------------H---------------------------------
-R----------------------------------------------------------------------------------------------R---
N-----------N---------NV---H---B-N--------------V--N-----BB--------B-------------------------------H
----------------------------------R----------R-------VR------------R-------N------------------------
----------------B--N----------H-----------------H-----------------------------N----------B----------
----------------------------------------------R---R---R---------------------------------------------
-----------------------------N----H------------------------H------N-----B-N-------------------------
-----R-------------------------------------------------------R-------------------S-----R---R--------
-----H------V-------------------M-B----------------N----------N---VM----------V----------M----V-----
------R-------------------------------------R--------------RR---------------------------------R-----
-------------------N------M-M---------------B------------------------------------------------------M
-R------S-----R-----------------R-----------------R-------------------------------------------------
-----------------------------------------B-----M-V-------------------------------B---B--N---------N-
----------------------------------R-----------------------------------------------------------------
----------------H----N-------------V---B----B-----------------------------------------------N------H
--------R--R----------------------R-----------------------------------------------------R-----------
H----------------------H---B------------------------------------V-------B------------------H--------
--------------------------------------------R------------------------------R------------------------
---------B-B--------------------------------B-------------------------------------------------------
-----------R----R--V-----R---------------N----------------------R------------R--------R-------------
-----V-------------------------------------------------------------------B-------------------V---H--
----------------------------------------------R------------------------------------------------R----
-VH----------N----V---------M-----------H----V--B---------------V------------------N----------------
----R----------------------R--V---------------------N-----------------------------------------------
-B-------M-N------B-V-------------N-------------------------------B---------------------------------
----------------R----R-----------------------------------R----------------------------------------R-
----------------------B---------M---------------------NB--------------------M--------------B-B------
--R-R------------------------S----------------R-----------------R---R-R----------------R------------
--------------------------B-------------V--------------H-----N-----B----------V---------------------
--------------R------------------------R-------------------------R--------------R-------------------
