--------------------N----N------------N-------------B--------------V-------------H------------------
-----------R----------------------------------------------------------------------------------------
----H------B-B---------------------------V----------------------B-------B---V----------H------------
----------R-------R---------------------R-----------------R---R---------R--R------------S-----------
--------------------------M-V-----------H----------------------HM-------------------------------B---
-------------------------------------------------R-------------------------------R------------------
-----------------------------------------------------------B----V------N---B----------B----V------B-
------------------------R-------------------------R-------------------------------------------------
----------------N----V-----------N-----------BB-H-------------------B-------N----------H------------
------------------------------------R---------------------------------------------------------------
------N--------------------N-----------------------------------------------------------------B------
-R--------------------------------------------------------------------------------------------------
---------------------B--------V--------B--------------------------N---------------------------V-----
-------------------R-R------------------------------------------R-----------------------------------
----M------------------------M---------------------V--------------------------------V---------------
------------------R---------------R---------------R-----------------------------------RR------------
---------H--------------------------------V----------------------------------H-----------------N----
----R-----------------R-------------------------R-------------------------------------------R-------
----H-----------------H------------------------------------------H-----------H-------N--------------
------------------R------------------------------R--------R----------------R------------------------
-------N---------------H-NBH------------B---------H----------------N-----------------------V-------N
------------------------------R--------------------------------H--------R-------------R-------------
--------------NN--------V------------------------------H------------------N------------M---V--------
-------------------R-----------------------R-----R---R----------------------------------------------
-------N-----------B----N--------H---B-H----------------N----------B---------V-----N-------H---B----
S---------R-------------------------------------------------R-----RR--------------------------------
--------------------------------------------------N--N---------------B-------------H----------------
---------------------------R------------------------------------------------------------------------
H------------V---H----------------------------H------H----V----V---V-----------B------H-------V-----
---------------------------------------------R-------R----R-------------------------------------R---
----------------V-------------------------------------------------------------B--N-----------N-----H
--------------------------------------------------------R------------------------------------------R
--------------------------------------------M----------H--V-------N----------------------V--------V-
--RR-------R-----------------------------------R-----R-----R---------------------------R------------
------------B-----N-------H------------------------V--B------------V-------------H------------------
--------R---R--------------R-----------------R-----R-----SR--------R---------------H-------------S--
-------NN--------------------B----------------------------------M----H-----------------------------V
-------R------------R-----R------------------------------------------------------------------R------
----------------N------H-----H----------N---H-H---------------H---------H--NNN------N---------------
-------------R----R---------------------------------------------------------------R----------------R
---------------------------M------------------V------------V---------B------------------------H---B-
---------------------------------R---------R--------------------------------------------R-R---------
----------------V--M---------------M------------------V-------H-------------------------------------
-------R-----------------------------------------------------------R------R-------------------------
----------------------------------------------------------------------B-------------------M---------
--------R------V------R--------------N----R---------RS-R--------------------------------------------
----------------------N---N------------------------------N------H-----------------------H---H---N---
-----------R----R--H--------------------------------------------------R---S----R--------------------
--M---------V-------------------V------------------------H---V-----N------H------------------------B
--------------R----R-------------R----R--------------------------------------R--R------R------------
-----VM------V-----------V-----------------------------------H-------------------------V-----------N
-----------------------------------------R-----------S---V---------------------N------R---------R---
--------------------------------------N-----------------------------N-----------------M-------------
------------------R---------------------------H-------------R-----------R---------------------------
------------B-------B-------------------------------------B-----------------------------------------
-R----------------------------------------------------------------------------------------------R---
-----VB----------V-----------------------V------------------------------N----N-------N--------------
-----------------------S----------R----------R-------VR------------R-------N------------------------
--------------------------V---------------B-----------------N-----------------------------------H---
--------------------S-------------------------R---R---R---------------------------------------------
-------------------------------V--------V-----------------V-----V----------------------H------------
-----R-------------------------------------------------------R-------------------------R---R--------
--------------------------------------------------------------------------H------------V------------
------R-------------------------------------R--------------RR---------------------------------R-----
-----------------------B------------------------------------------------BN-------------B------------
-R------R-----R-----------------R-----------------R-------------------------------------------------
---------V-H---H---------N----------------B----------------------------------------------------B----
----------------------------------R-----------------------------------------------------------------
B-----B---------------------------------H----N---------------V---------------------V----------------
--------R--R----------------------R-----------------------------------------------------R-----------
N---B---------V-------------V--------H--------------H--------B------V---------N--------------N---V--
--------------------------------------------R------------------------------R------------------------
-------HB--------H----B-----------N------------------------H----------------------------------------
-----------R----R--V-----R---------------N----------------------R------------R--------R-------------
---------------------------------------------------------H-N-------B--------------------------------
----------------------------------------------R------------------------------------------------R----
-------------V--------------------------B------B---------------------------------------------------B
----R----------------------R--V-----------------S---N--------------------S--------------------------
---------M--------------------------------V------N--H----------------------------N------------------
----------------R----R-----------------------------------R----------------------------------------R-
---------------------H----------M-V------------V-----------------------N-------------------------N--
--R-R-----------------------------------------R-----------------R---R-R----------------R------------
----------------B-------------------------------------N----M------------B----B--------------------B-
--------------R------------------------R-------------------------R--------------R-------------------
