------------------------H-------------N----------------------------------------B--------------------
----------------------------------------------------------------------------------------------------
-----B----V-------------------------N-----------------------------------N---------------------------
------------------R-----------------------------------------------------R-------------XXS-----------
-------------------------------------------V-----------------------------------------XXXX-----------
------------------------------------------------------------------------------------XXXXX-----------
---V-------------------------------------------------------------------------------XXXXX------------
------------------------R-------------------------R-------------------------------XXXXX-------------
---------------------------------------------------------------------------------XXXXX--------------
--------------------------------------------------------------------------------XXXXX---------------
---------B------------------------------------------H--------------------------XXXXXH---------------
-R--------------------------------------------------OOOOOOOOOOOOOOO-----------XXXXX-----------------
----------------------------------------------------OOOOOOOOOOOOOOO----------XXXXX-----------N------
-------------------R-R------------------------------OOOOOOOOOOOOOOO---------XXXXX-------------------
--------------------------H-------------------------OOOOOOOOOOOOOOO----NH--XXXXX-H---------H--------
----------------------------------R-----------------OOOOOOOOOOOOOOO--------XXXX-------RR------------
----------------------------------------------------OOOOOOOOOOOOOOO-------XXXX----------------------
----------------------R-----------------------------OOOOOOOOOOOOOOO------XXXXX----------------------
------------------B----V----------------------------OOOOOOOOOOOOOOO-----XXXXX-----------------------
-------------------------------------------------R--OOOOOOOOOOOOOOO----XXXXX------------------------
------------------------B---------------------------OOOOOOOJOOOOOOO-B-XXXXX------------N------------
------------------------------R---------------------OOOOOOOOOOOOOOO--XXXXX------------R-------------
----------------------------------------------------OOOOOOOOOOOOOOO-XXXXX---B----------M-H------V---
-------------------R--------------------------------OOOOOOOOOOOOOOOXXXXX----------------------------
----M-----------------------------------------------OOOOOOOOOOOOOOOXXXX--------------------H--------
SXX-------------------------------------------------OOOOOOOOOOOOOOOXXX------------------------------
XXXX----------------------------------------N-----N-OOOOOOOOOOOOOOOXXX------B-----------------------
XXXXX----------------------R------------------------OOOOOOOOOOOOOOOXX-------------------------------
-XXXXX-----------H--------------B-------------------OOOOOOOOOOOOOOOXX--B----------------------------
--XXXXX--------------------------------------R------OOOOOOOOOOOOOOOXX---------------------------R---
---XXXXX--------------------B-----------------------------------XXXXX---------------------N---------
----XXXXXXXXX--------------------------------------------------XXXXX--------------------------------
-----XXXXXXXXXXXXXXXXXXXXXXXXXXXXXXXXXXXXXXXXXXXX-----------B-XXXXX---------------------------------
--R---XXXXXXXXXXXXXXXXXXXXXXXXXXXXXXXXXXXXXXXXXXXX---------R-XXXXX---------------------R------------
-----------XXXXXXXXXXXXXXXXXXXXXXOOOOOOOOOOOOOOOXXX--V------XXXXX--V----N----------V------------H---
--------R---R--------------R-----OOOOOOOOOOOOOOOXXXX---XXSRXXXXX-------------------H-----------XXS--
--------------N------------------OOOOOOOOOOOOOOOXXXX--XXXXXXXXX-----------N--------N---B------XXXX--
--------------------R-----R------OOOOOOOOOOOOOOO-XXX-XXXXXXXXX-------------------------------XXXXX--
-----------------------H--------NOOOOOOOOOOOOOOO-XXXXXXXXXXXX----------------V-------------VXXXXX---
---------------------------------OOOOOOOOOOOOOOO-XXXXXXXXXXX-----------------------------XXXXXXX----
B--------------------------------OOOOOOOOOOOOOOO-XXXXXXXXXX--XXXXXXXXXXXXXXXXXXXXXXXXXXXXXXXXXX-----
---------------------------------OOOOOOOOOOOOOOO-XXXXXXXXXXXXXXXXXXXXXXXXXXXXXXXXXXXXXXXXXXXXX------
------------------------------N--OOOOOOOOOOOOOOO-XXXXXXXXXXXXXXXXXXXXXXXXXXXXXXXXXXXXXXXXXX--N------
-------R-------------------------OOOOOOOJOOOOOOO-XXXXXXXXXXXXXXXXXX---------------------------------
------VBV------------------------OOOOOOOOOOOOOOO-XXXXX--XXXXXXXXXXXXXXXXXX--------------------------
---------------V------R----------OOOOOOOOOOOOOOO-XXXXS-R-XXXXXXXXXXXXXXXXXX-------------------------
-----------------V---------------OOOOOOOOOOOOOOO-XXXXX-----------XXXXXXXXXX-------------------------
-----------R----R----------------OOOOOOOOOOOOOOO-XXXXXX---------------R-XXS-------------------------
---------------------------------OOOOOOOOOOOOOOOXXXXXXX---------------------------------------------
---------------------------------OOOOOOOOOOOOOOOXXXXXXX--------------------------------R------------
-----V-------------------------H-OOOOOOOOOOOOOOOXXXXXXX----------------------------B----------------
---------------------------------OOOOOOOOOOOOOOOXXXXXSX-----------------------------------------R---
-------------M-------------------OOOOOOOOOOOOOOOXXXXXXX---------------------------------------------
------------------R-----XXXXXXXXXXXXXXXXXXXXXXXXXXXXXXX-----R---------------------------------------
---------N-------------XXXXXXXXXXXXXXXXXXXXXXXXXXXXXXXX------------------------------N--------------
-R--------------------XXXXXXXXXXXXXXXXXXXXXXXXXX-XXXXXXX----------------------------------------R---
---------------------XXXXXX----------------------XXXXXXXX-------------------M---------------------H-
--------------------XXXSXX--------R----------R---XXX-XXXXX---------R--------------------------------
--------------------XXXX------------------------XXXX--XXXXX-----------------------------------------
--------------------SXX-----------------------R-XXXX--RXXXXX----------------------------------------
------H--N----------------V---------N---N-------XXX-----XXXXX---------------------------------------
------------------------------------------------XXX------XXXXX-----------------------------R--------
------------------------------------------------XXX-----B-XXXXX---N----------------------B----------
------R-------------------------------------R---XXX--------XXXX-------------------------------------
---------------------------------------N--------XXXB-V------XXX------------------------------------M
------------------------------------------------XXX---------XXXX------------------------------------
---------------------------------H-------------MXXX---------XXXXX-----------------------------------
------------------------------------------------XXX----------XXXXX----------------------------------
---N----------------------------V---------------XXX--------B--XXXXX----------------------V-B--------
--------R-------------------------R-------------XXX------------XXXXX--------------------R-----------
-------H--------H----------NH-------------------XXX-------------XXXXX-------------------------------
--------------------------------------------R---XXX--------------XXXXX------------------------------
------------------N----------V------------------XXX---------------XXXXX-----------------------------
----------------R--V-----R---------------N------XXX----------------XXXXX-----R--------R-------------
---------VH-N--------------------N--------------XXX---------H-------XXXXX----------------------B----
----------------------------------------------R-XXX------------------XXXXX---------------------R----
-----------------------------------B-----------BXXX-------B-----------XXXX------V------------------N
----R-------------------------------------------SXX--------------------XXS--------------------------
-------------------N------------------------------------------B-------------------------H-H---------
----------------R----------------------------------------R----------------------------------------R-
--V---N-------------------------M------------------------------------------------------HV----------H
----R-----------------------------------------R-----------------R---R------------------R------------
--------------------------N------------B-------------M---------------N-------------------B----------
---------------------------------------R-------------------------R----------------------------------
