---------------------------------------------------R---------R--------------------------------------
----------------------------------------------------------------------------------------------------
----------------------------------------------------------------------------------------------------
-----------------------------------------------------------------------------------------M----------
--------------------------------------------------------------------R-------------------------------
-M--------------------------M-----------------------------------------------------------------------
----------------------------------------------------------------V------B----------------R-R---------
----------------------M-----------------------------------------------------S----------------M------
----------------R----------------------------------------------------------X----------------------BR
----------------------------------M-------M-------------------------------X-------------------------
----------------------------------------------------------------R---R----X---------------------N----
------------------------M-----------------------------------------------X---------------------------
----------B-----------------------------------------H-------R----------X----R-----------------------
-M-----------------------------------------------M--------------------X-----------------------------
---------------------B-R--R------------------------------------------X-------------------H--------B-
------------M--------------------------------------------------M----X-------------------------------
--------------R----------R--------H--------------------------------X--------------------------------
------------------------------------------------------------------X---------------------------------
----------------------H--------------------V-------R-------------X----------------------------------
----------------M----------------------------M------------------X-----------------------------------
-------------------------------------------R-------------------X----R-----------------N-------------
--------------------------------------------------------------X-------------------M-----------------
-----R-----H------------------------------V------------------X----------V---------------------------
------------------------------------------------------------X----------------------M----------------
---------------R---------------------------R---------------X-----------------------------H----------
----------------M-----------------------------------------X------------------------------------M----
---------------------------------------------------------X------R-----------------------------------
--------------------------------------------------------X--------------------M----------------------
------------H--------------------R---------------------X--------------------------------------------
-----------------------------M------------------------X---------------------------------------------
------------------------------------------R----------X-----N--------------------R------N------------
-----------M-----------------------------------------X----------------------------------------------
-V------------N---H--N-------------------------------X-------------------------------V--------------
-----------------------------------------------------X-----M----------------M-----------------------
----------------------------------B---------B--------X-----------R------R------V-------------------N
---M-------------------------------------------------X-----------------------M----------------------
------------R----------------------------------------X----------------R---------------------N-------
----------------------------------------------------X------------------------------------M-------M--
---------------------------------------------------X--R------H--------------------------------------
-------------M-------------------------M----------X-------------------------------------------------
----------B---------------------------------------X----------------------------------------------R--
-------------M------------------------------------X-------------------------------------------------
-------------------------------XXXXXXXXXXXXXXXXXXXXXXX--R-------V-----------------------H-----------
-----------------------------XX-------------------X---X---------------------------------------------
----------------XXXXXXXXXXXXX---------------------X----X-----------R--------------------------------
---------------X----------------------------------X-----XXXXXX----------------------M---------------
V-------------X---OOOOOOOOOOOOOOO----------------X------------X-----R-------------------------------
-------------X----OOOOOOOOOOOOOOO---------------X--------------X------------------------------------
---R--------X-----OOOOOOOOOOOOOOO--------------X----------------X----R------------------------------
-----------S------OOOOOOOOOOOOOOO--------------X---------M-------X---------------M------------------
------------------OOOOOOOOOOOOOOO---R----------X--H---------------X---B-----------------------------
------------------OOOOOOOOOOOOOOO-------------X--------------------S-----------OOOOOOOOOOOOOOO------
--------N---------OOOOOOOOOOOOOOO------------X------------------R--------------OOOOOOOOOOOOOOO------
---M----M---------OOOOOOOOOOOOOOO-----------X----------H-----------------------OOOOOOOOOOOOOOO------
------------------OOOOOOOOOOOOOOO----------X---------------H-------------------OOOOOOOOOOOOOOO------
------------------OOOOOOOJOOOOOOO---------X------------------------M-----------OOOOOOOOOOOOOOO------
------------------OOOOOOOOOOOOOOO--------X------------------------R------------OOOOOOOOOOOOOOO------
------------------OOOOOOOOOOOOOOO-------X-------------------------------M-M----OOOOOOOOOOOOOOO------
------------------OOOOOOOOOOOOOOO------X-------R-------------------------------OOOOOOOOOOOOOOO------
------------------OOOOOOOOOOOOOOO-----X------------------------------------M---OOOOOOOOOOOOOOO---M--
---H--------------OOOOOOOOOOOOOOO----X--V-V------------V----N--------------N---OOOOOOOJOOOOOOO------
----M-------------OOOOOOOOOOOOOOO---X------------------M-----------------------OOOOOOOOOOOOOOO------
------------------OOOOOOOOOOOOOOO--X------------------------------------N------OOOOOOOOOOOOOOO------
--------------S---OOOOOOOOOOOOOOO-X----------V-------------------N-------------OOOOOOOOOOOOOOO------
---------------X--OOOOOOOOOOOOOOOX----------R----------------------------------OOOOOOOOOOOOOOO------
----------------XXXXXXXXXXXXXXXXX--------------------------------------M-------OOOOOOOOOOOOOOO------
-N--------------------------X--------------------------------------------------OOOOOOOOOOOOOOO------
---------------------------X---------------------------------------------------OOOOOOOOOOOOOOO-----M
--------------------------X----------------------------------------------R-----OOOOOOOOOOOOOOO------
-------------------------X----------------M-----------M------------------------OOOOOOOOOOOOOOO------
---------H--------------X---------------------------------------------------------------------------
-----------------------X----------------------------------------------------------------------------
----------------------X-------------------------H---R-------------------------------------R---------
---------------------X------------------------------------------------------------------M-----------
--------------------X-------------------------------------------------------------------------------
-------------------X---------------------------------------------------------------M----------------
V-----------------X----------R----------------------------------H-----------------------------------
-----------------X----------------------M---------------------------------------------M-------------
----------------X----------------------------------------------------------------R---------V--------
---------------X----------------------------------------M-------------------------------------------
--------------X-----------------------R-----------------------------N-------------------------------
-------------S--------------------------------------------------------------------------------------
R---------------------------------R---V-------------------N--------------------------------------N--
----M--------------------------M--------------------------------------------------------------------
