-----------------------------------------------------R-----H---------H---------H-----V-----H---R-R--
-------------R-----H-----------H-----V---V-R-----R-----R---R-H-------R-----H-----------------R------
---------------------------------------------H-------R-H---V-----V-----H-----H-----V-----R-----V----
-----------------V-----V-----R-----V-V-----V-----------------H-------V---R-------R------------------
---------------------------------------------------V-------V-----H-H-----H---H-------H---H-V---H-R-V
-------------------------H---------V-H---H-----R---V-H---------V-----R---H-H-------V-V--------------
-------------------------------------------------------------H-R-----H-V-----R-R---R-V-------------R
-------------------------------------R-----H-H-------H-V-V-----H-----H---V--------------------------
-----------V-----H-----------H---V---H-H---------H---------H---------H-------V-----R-----H---------H
---------------------------H---------------H-------------R-----R---------H-----R-----R-----H-V------
-----------------R-----H---------R-----V-------------------------------------------V-------H---V-R--
---------------H-----V-----R-H---V-----H---------V-------V---V-V---V-H-------R---V------------------
-------H---H-----H-R-R---V-R-V-R-H---------R-------------------------------V-----R------------------
-------------V-----H---------H---------V---R-----H---------H---------H---------V-----R---H----------
---V-----V-----R-H---R-----R-V-----H---------H-----H-----------R-------H----------------------------
-----------------------------------H-H-----H-H-H-----R-R-----V-----------H---------------------V----
-----------H-----H---R---H-H-----H-H-------V---V-V-------------------------------------V-----V------
----------------H--------------------------------------------------R-----R-V---R-H-----H---H-----V--
---------V-----H-----------R-----H-----V---------V-------R-----------V-----H---------R-----H--------
---------------------------H---------R-R---V-H---V-----H---V-----H---------V-----V-----R-----V-----R
---------R-----V-------------------------------------------------------------R-----H---------H---R--
-------------------------H---------H---------H-H-------V-V---H-H-V-----V-R---R-H-H------------------
---------------R-------H-----R-----R-------H---------R-----------R-----V---R-H---R-----V-----H------
---------R-----H---------H-------V-H---H-----V---H-----V-----V-----R-----R-----R-----V--------------
-------------------------------------H-------R-H---V-----H---------R---V-----R-----R-----R-R---V----
---------------------H-----R---H---R-----H---------V---H-H-----V-H---------H-------V-R---------R----
---------------------------------------------------V-------R-----H---------R-----V-----H-----V-V-H-H
------V--------R-----V----VV---V-V-----V---H-V---V-R---------------------V-----R-------V-----R------
-------------------------V-----H---V-----H-H-------R-----R-------------------------H---V-----V-----V
---------------V-----V-------R-R-----R-----R---H-V---------R-----R-----------------------------H----
---------------------------------------H---------V-----R-H-V-V---H---V-----V-H---V-----R------------
---------V-----H-----------H---------------------------------R-----V-----V-----R-----R-V-------V---H
---------------------------------R-----H---------V-------V-H-----R-H-R-H-------H-R-------V-V--------
---------------------------------R-----H---H-----V---H-H-----R-R-R-R-V-R---H-R-----R----------------
-------------------R---V-H---H-----H---V-----R-----V---------------------------------------R-----V--
---------------H-------------H-----------------------------------------------------V-----V-V---H-R--
-------------R-----R-----H---------------------------------------------------------H-R-------V-R-R-R
-R-----R-----H---------V-----H-----------------------------V-----V-----V-----R---H-H-------H-----V--
-------------------------H---------H---R-----V---------------V-----H---------V-----H---------V------
-------H---------R-------H---------V---------V-----R-H---R-----H-R-H---R-----R-----H----------------
---------------------------R-----V---------R-------V-----V-----V-----------V-------H---------H-V----
-H---------H---------V-----V-----H---------H---------H---------R-----V-----R-----R-----R-----R-----R
-----------------V-----V-----------H---------H---R-----V-----H-R-----H-----------------------R-----R
---------------V-----R---------H---------H---------H---------R-------------------------V-----H-----V
-R-----R-----R-----H-R---H-------V-H---R-----R-------V---------R-----H---------V-------V------------
-----------H---H-------V---R-R---H-V---------R-----R---R-----V-----V-----R--------------------------
-------------R-----V-------V---------V-----------------------------H---------------R-----R-----R---H
-----------------------H-----------R-V---R---H-V-----H-R-----V-H---------V---------------------R----
-----------------------------V-----V-----------R---H-H---------R-H-V-H-----V---R-H---------V--------
---------------------------H-----------R-----R-----V-----R-----H---------H---------R-----R-----R---R
-----------V-----V-----V---H-V---H---V-V-----H---------R-------------R-----R---------R--------------
-------------------H---------R-----R-----R-------------------H---------R---V-R---H-V-----V---H---H--
---------------------------------H-----------H-----V-----R-----H-------V-V-------R-----H-------H----
-----------------R-----R-----H-----R---R-H---R-----V-----V-----V-V-----H-----R-----H---------H------
-----------------------------R-----H---R-----R-----H-----H---H-H---V-----R-------R-----V------------
-----H-----R---R-----V-----R-------------------------------------------------------H-----R---H-R----
---R-----R-----V-----V---------------R-R---H-H---R---H-R-H---H-H---R---V-R---V----------------------
-----------------------------------H---------V-----V-R--HR-V---H-R---------------H---R-----R-H---V--
-------------------------V-------H-----V-----R-----H-V-------H---------V-----H-------R-V---R--------
-----------H-----H-----V---H-V-----V-H---------H---------H-----R-----R-----R------------------------
-------------------------------H-------------R-----V-------------------V-----H---H-----V-----H-V-H--
---------------V-H---H-----V-----H---------H---------------------------------------------R-----H-V--
-----------H-------V-----R---------R---------R-----------------------------------------H---------R--
---------------------------------------H-------R-R---H-V-----V-R---R-R---R-H---V-----R---R-V---R----
-------------------------------V-V---H-H-------R---R---R---------------V-----H---------V-----R-----R
-----R-----R-----V-------------------------H-----------R-----V-----R---H---R-----V-V---V-V---R-H----
---------H---------R-------R-----V-------------------------------V-R-----R-----R-----H---H-----R---H
-----------H---------R-----R-----V-----V-----VV----H---------H----V----V-----------------------V----
---------------------------V-----H---------R-------H-----------R---------H-------------R-----R-----V
---------------------------R-----V-------R-----V-------V-----------H-----R-----H---------H-------R--
-----------R-------H-H-------V-----H-----------------------------------V-------------V-----H---H----
-------H---------R-------V-------------R-----V-----V-----V-----V-------V-----R-----R-------H-------V
-------R-------R-----------------------------------V-----R-------V-R---V-H---------H-----R---H-R----
---------------------------------------------------------------------H-V-----R-H---V-----V-----R----
-------------R-----R---R-R---R-R---V-H-----V-----------------------------V---------H-----R-----V----
---V-------H-----------H-----R-----V-----V-----R-------------------------------------V-R---R-R---R-R
---V-----R-----H-----------------------------------------V-----H---------V-V---V-H---H-----H---V----
-----------------------V-----R-----V-----R-----H---------------------------------------V-----R-V---V
-R-------V-------R---------V---R-R---H-R-------V-----H---------V---------------------------R-------H
-------------------------------------------------------V-----R---H---H-----R---H-V---R-H-----V-H----
-------V---V-V-----R-----V-----V---------------------------------------------H-H-------V---R-H-----R
-----H---R-----R---H-H---------R-------V-----H---------R-----R-----H-----------H---------V-----H----
-------------H---------R-----H---------V-----------------H-------R-R-----H-H-------R-V-----H--------
-------------------------------V-----R-----V-------V-V---R-R---H---------H---------H-------------R--
